Level 5
9
9
#####    
#   #    
# X # ###
# X # #O#
### ###O#
 ## @ XO#
 #   #  #
 #   ####
 #####   
