Level 4
8
7
 #####  
##   ###
# O# X@#
#  # # #
#  X  O#
#     ##
####### 
