Level test
26
8
##########################
# O##  X   O##   #   #####
# X##       ##   #   #   #
#       X                #
#  #    O   ###          #
#  #        ###   @      #
#  #                     #
##########################
