Level 1
14
5
##############
#   X  O     #
#   @   X    #
#   X  O   O #
##############
