Level 2
14
5
##############
#      #O    #
#   @  #X    #
#      X    O#
##############