Level test 2
26
8
##########################
# O##  X   O##           #
# X##       ##           #
#       X                #
#       O        O       #
#   @            X       #
#                        #
##########################
